20
20
OOOOOOOOO..OOOOOOOOO
OOOOOOOOO..OOOOOOOOO
OOOOOOOOO..OOOOOOOOO
OOOOOOOOO..OOOOOOOOO
OOOOOOOOO..OOOOOOOOO
OOOOOOOOO..OOOOOOOOO
OOOOOOOOO..OOOOOOOOO
OOOOOOOOO..OOOOOOOOO
OOOOOOOON..EOOOOOOOO
....................
....................
OOOOOOOOW..SOOOOOOOO
OOOOOOOOO..OOOOOOOOO
OOOOOOOOO..OOOOOOOOO
OOOOOOOOO..OOOOOOOOO
OOOOOOOOO..OOOOOOOOO
OOOOOOOOO..OOOOOOOOO
OOOOOOOOO..OOOOOOOOO
OOOOOOOOO..OOOOOOOOO
OOOOOOOOO..OOOOOOOOO